12 12
R_ R_ R_ R_ R_ R_ R_ R_ R_ R_ R_ R_
R_ Do D_ D_ D_ G_ G_ W_ W_ W_ W_ R_
R_ D_ D_ D_ D_ G_ G_ W_ W_ W_ W_ R_
R_ D_ D_ D_ D_ G_ G_ D_ D_ D_ Do R_
R_ Dx D_ G_ D_ Gp G_ D_ D_ D_ Dx R_
R_ D_ D_ G_ G_ Gx G_ D_ D_ D_ D_ R_
R_ D_ D_ G_ G_ D_ R_ R_ D_ D_ D_ R_
R_ D_ D_ G_ G_ D_ D_ D_ D_ D_ D_ R_
R_ D_ D_ G_ G_ D_ D_ D_ D_ D_ D_ R_
R_ D_ D_ G_ Gx G_ G_ G_ G_ G_ G_ R_
R_ Do D_ D_ D_ D_ D_ D_ D_ D_ Do R_
R_ R_ R_ R_ R_ R_ R_ R_ R_ R_ R_ R_