12 12
R_ R_ R_ R_ R_ R_ R_ R_ R_ R_ R_ R_
R_ Dp D_ D_ D_ G_ G_ W_ W_ W_ W_ R_
R_ D_ D_ D_ D_ G_ G_ W_ W_ W_ W_ R_
R_ D_ Dx D_ Do G_ G_ D_ D_ D_ D_ R_
R_ D_ W_ G_ Dx G_ G_ D_ D_ D_ D_ R_
R_ D_ W_ G_ G_ G_ G_ D_ D_ D_ D_ R_
R_ D_ W_ G_ G_ D_ R_ R_ D_ D_ D_ R_
R_ D_ W_ G_ G_ D_ D_ D_ Dx R_ Do R_
R_ D_ W_ G_ G_ D_ D_ D_ D_ D_ D_ R_
R_ D_ W_ G_ G_ G_ G_ G_ G_ G_ G_ R_
R_ D_ W_ Do D_ D_ D_ D_ D_ D_ D_ R_
R_ R_ R_ R_ R_ R_ R_ R_ R_ R_ R_ R_