12 12
R_ R_ R_ R_ R_ R_ R_ R_ R_ R_ R_ R_
R_ D_ D_ D_ D_ D_ D_ G_ G_ G_ W_ R_
R_ D_ G_ G_ G_ G_ G_ G_ G_ G_ W_ R_
R_ D_ G_ G_ G_ G_ G_ G_ G_ G_ G_ R_
R_ D_ G_ G_ G_ Go Do Do G_ G_ G_ R_
R_ D_ D_ D_ D_ D_ Dp Do R_ G_ G_ R_
R_ D_ R_ R_ R_ R_ Gx Gx Gx G_ G_ R_
R_ D_ W_ W_ G_ G_ Gx D_ D_ G_ D_ R_
R_ D_ G_ G_ G_ D_ D_ D_ D_ G_ D_ R_
R_ D_ G_ G_ G_ D_ D_ D_ D_ G_ D_ R_
R_ G_ G_ W_ W_ W_ G_ G_ G_ G_ D_ R_
R_ D_ R_ R_ R_ R_ R_ R_ R_ R_ R_ R_