12 12
R_ R_ R_ R_ R_ R_ R_ R_ W_ R_ R_ R_
R_ G_ G_ G_ D_ R_ G_ R_ G_ G_ Go R_
R_ G_ R_ G_ D_ Gx G_ R_ D_ D_ G_ R_
R_ G_ Gx G_ D_ R_ G_ R_ D_ D_ W_ W_
R_ R_ R_ G_ Dp R_ G_ R_ W_ D_ W_ R_
R_ Do R_ G_ D_ R_ G_ R_ W_ D_ D_ R_
R_ D_ R_ G_ D_ Gx G_ R_ G_ Dx D_ R_
W_ D_ D_ D_ D_ D_ D_ D_ D_ D_ R_ R_
R_ G_ W_ R_ D_ D_ R_ R_ D_ W_ W_ W_
R_ G_ W_ R_ D_ D_ D_ D_ D_ D_ Go R_
R_ Go G_ D_ D_ D_ W_ R_ R_ G_ G_ R_
R_ R_ R_ W_ R_ R_ W_ W_ W_ W_ W_ R_
