12 12
R_ R_ R_ R_ R_ R_ R_ R_ R_ R_ R_ R_
R_ D_ D_ D_ D_ G_ G_ W_ W_ W_ W_ R_
R_ D_ D_ D_ D_ G_ G_ W_ W_ W_ W_ R_
R_ D_ D_ D_ D_ G_ G_ D_ D_ D_ D_ R_
R_ D_ W_ Gp D_ G_ G_ D_ D_ D_ D_ R_
R_ D_ W_ G_ G_ G_ G_ D_ D_ Do D_ R_
R_ D_ W_ G_ G_ D_ R_ R_ D_ D_ D_ R_
R_ D_ W_ G_ G_ D_ D_ D_ D_ D_ D_ R_
R_ D_ W_ G_ Gx D_ D_ D_ D_ D_ D_ R_
R_ D_ W_ G_ G_ G_ G_ G_ G_ G_ G_ R_
R_ D_ W_ D_ D_ D_ D_ D_ D_ D_ D_ R_
R_ R_ R_ R_ R_ R_ R_ R_ R_ R_ R_ R_